10
G.G.-.-.P.-.-.-.-.-
G.G.-.-.P.P.-.-.G.-
-.-.W.-.P.-.-.-.-.-
-.-.-.-.-.-.-.-.-.-
P.-.-.-.-.-.-.-.-.-
-.-.-.-.-.-.-.-.-.-
-.-.-.-.-.-.P.-.-.-
-.-.-.-.-.-.-.G.-.-
-.-.-.-.-.-.-.-.P.-
A.-.-.-.-.-.-.-.-.-


